W.W.W.W
EXEXEXE
W.....W
WX.P.XW
W.....W
EXEXEXE
WW.W.WW