XXXXXXXXXXXXXXXXXXXXXXXXXXXXXX
X............................X
X............................X
X............................X
X............................X
X............................X
X............................X
X............................X
X............................X
X............................X
X............................X
X............................X
XWWWWWWWWWWWWWWWWWWWWWWWWWWWWX
X............................X
X.............P..............X
X............................X
XWWWWWWWWWWWWWWWWWWWWWWWWWWWWX
X............................X
X............................X
X............................X
X............................X
X............................X
X............................X
X............................X
X............................X
X............................X
X............................X
X............................X
X............................X
XXXXXXXXXXXXXXXXXXXXXXXXXXXXXX